8
5
33303333
02303000
00050030
00303030
00303000
